###############
M0###0000000###
#0###0#####0###
#0###0##0000###
#0###0#####00##
#000000##000###
#0#0######00###
#0##00000##00##
#0##0###00##0##
###0####0##000#
###0000000000##
##00###0#######
##0##0#0#######
##000000000000G
###############
